############################
#S     #         #        #
# ### ####### ## # ###### #
# #   #     #  # #      # #
# # ##### # ## # ###### # #
# #     # #    # #    # # #
# ##### # ###### # ## # # #
#     #        # #  # #   #
##### ######## # ## # #####
#     #      # #    #     #
# ### # #### # ###### ### #
# #   # #    #        #   #
# # ### # ########## #####
# #   #   #        #     #
# ### ####### #### #######
#     #     #    #       #
##### # ### # ## #########
#   #   # # #  #         #
# ### ### # ## ####### ###
#     #   #    #     #   #
# ### ####### # ### ### ##
# #         # #   #     E#
############################

